SO textures/so.PNG
NO textures/no.PNG
WE textures/we.PNG
EA textures/ea.PNG
F 54, 69, 79
C 50, 54, 55

1111111
K0001
1111111
1000001
1E0000P
1000001
111D111
1000001
1000001
1000001
P00000K
1111111