NO textures/no.PNG
SO textures/so.PNG
WE textures/we.PNG
EA textures/ea.PNG
DO textures/door.PNG

F 54, 69, 79
C 77,164,240

        1111111111111111111111111
        1000000000FF0000000000001
        1011000001110000000000001
        10010000000000000W0000001
111111111011000001110000000000001
100000000011000001110111110111111
111111111111111111111111111111111
