SO textures/so.PNG
NO textures/no.PNG
WE textures/we.PNG
EA textures/ea.PNG
F 54, 69, 79
C 50, 54, 55

1111111
1P01
1111111
1000001
1E000P1
10000K1
1111111
1K00001
1111111