SO textures/so.PNG
NO textures/no.PNG
WE textures/we.PNG
EA textures/ea.PNG
DO textures/barrel.png
F 54, 69, 79
C 50, 54, 55

111111111111111111111111111111111
        11111111111111111F1111111
11111111111111111111000000001
10000000000000000001111111111
100Atextures/a.PNG01
10000000000000000001
111111111111111111111111111111111
        1000000000110000000000001
        1011000001110000000000001
        10010000000000./0P0G0A0001
111111111011000001110000000000001
100000000011000001110111110111111
111111111111111111111111111111111
 
11111111111111111111111111111
11110111111111011100000010001
11110111111111011101010010001
110000001101010111000000100011111
1000000000000000110000xusra01000F
100000000000000000000000000000001
100000000000000011010100100011111
1100000111010101111101111000111
11110111 1110101 101111010001
11111111 1111111 111111111D11
        1111111111111111110111111
        1000000000110000000000001
        1011000001110000000000001
        1001000000000000000000001
11111111101100000111000BB0CC0DD01
100000000011000001110111110111111
11110111111111011100000010001
11110111111111011101010010001
11000000110101011100000010001
10000000000000001100000010001
10000000000000001101010010001
11000001110101011111011110001
11110111 1110101 101111010001
11111111 1111111 111111111111
        1111111111111111111111111
        1000000000110000000000001
        1011000001110000000000001
        1001000000000000000000001
111111111011000001110000000000001
100000000011000001110111110111111
11110111111111011100000010001
11110111111111011101010010001
11000000110101011100000010001
10000000000000001100000010001
10000000000000001101010010001
11000001110101011111000000001
11110111 1110101 101111010001
11111111 1111111 111111111111
11111111 1111111 111111111111
        1111111111111111111111111
        1000000000110000000000001
        1011000001110000000000001
        1001000000000000000000001
111111111011000001110000000000001
100000000011000001110111110111111
11110111111111011100000010001
11110111111111011101010010001
11000000110101011100000010001
10000000000000001100000010001
10000000000000001101010010001
11000001110101011111011110001
11110111 1110101 101111010001
11111111 1111111 111111111111
        1111111111111111111111111
        1000000000110000000000001
        1011000001110000000000001
        1001000000000000000000001
111111111011000001110000000000001
100000000011000001110111110111111
11110111111111011100000010001
11110111111111011101010010001
11000000110101011100000010001
10000000000000001100000010001
10000000000000001101010010001
11000001110101011111000000001
11110111 1110101 101111010001
11111111 1111111 111111111111
11111111 1111111 111111111111
        1111111111111111111111111
        1000000000110000000000001
        1011000001110000000000001
        1001000000000000000000001
111111111011000001110000000000001
100000000011000001110111110111111
11110111111111011100000010001
11110111111111011101010010001
11000000110101011100000010001
10000000000000001100000010001
10000000000000001101010010001
11000001110101011111011110001
11110111 1110101 101111010001
11111111 1111111 111111111111
        1111111111111111111111111
        1000000000110000000000001
        1011000001110000000000001
        1001000000000000000000001
111111111011000001110000000000001
100000000011000001110111110111111
11110111111111011100000010001
11110111111111011101010010001
11000000110101011100000010001
10000000000000001100000010001
10000000000000001101010010001
11000001110101011111000000001
11110111 1110101 101111010001
11111111 1111111 111111111111
11111111 1111111 111111111111
        1111111111111111111111111
        1000000000110000000000001
        1011000001110000000000001
        1001000000000000000000001
111111111011000001110000000000001
100000000011000001110111110111111
11110111111111011100000010001
11110111111111011101010010001
11000000110101011100000010001
10000000000000001100000010001
10000000000000001101010010001
11000001110101011111011110001
11110111 1110101 101111010001
11111111 1111111 111111111111
        1111111111111111111111111
        1000000000110000000000001
        1011000001110000000000001
        1001000000000000000000001
111111111011000001110000000000001
100000000011000001110111110111111
11110111111111011100000010001
11110111111111011101010010001
11000000110101011100000010001
10000000000000001100000010001
10000000000000001101010010001
11000001110101011111000000001
11110111 1110101 101111010001
11111111 1111111 111111111111